
17 13
¦¦¦¦¦¦¦¦¦¦¦¦¦¦¦¦¦
¦ # ¦ / ¦ # ¦ / ¦
¦¦¦¦¦¦¦¦¦¦¦¦¦¦¦¦¦
¦ # ¦ # ¦ # ¦ # ¦
¦¦¦¦¦¦¦¦¦¦¦¦¦¦¦¦¦
¦ # ¦ / ¦ / ¦ # ¦
¦¦¦¦¦¦¦¦¦¦¦¦¦¦¦¦¦
¦ # ¦ # ¦ # ¦ # ¦
¦¦¦¦¦¦¦¦¦¦¦¦¦¦¦¦¦
¦ # ¦ / ¦ # ¦ # ¦
¦¦¦¦¦¦¦¦¦¦¦¦¦¦¦¦¦
¦ # ¦ # ¦ / ¦ # ¦
¦¦¦¦¦¦¦¦¦¦¦¦¦¦¦¦¦